111111111111111111111111111111111111111111111
1E100000000000000000000000000000000C000000101
100000000000000000000000000000100000000000001
100000000000000000000000000000000000000000001
111111111111000001111111111110000C00000000011
1CCCCCCCCCC0000001111111111111111111111110011
111111111111111111111111111100000000000000111
1P0000CCC000000000000000000000000000000000111
111111111111111111111111111111111111111111111