111111111111111111
1E10000000000001P1
100000000000000001
100000000000000001
111111111111000001
1CCCCCCCCCC0000001
111111111111111111