111111111111111
10E000000000001
10000CCC0000001
1000000P0000001
100000000000011
100000000000011
111111111111111