1111111
1000001
1P0C001
100E0E1
1111111